11111111
10C00E01
10P01001
1C0C1001
11111001
10C00C01
11111111
