11111111
10C00E01
10P01001
10001001
11111001
10000001
11111111
