11111111
10000001
10P00001
11111111
