111111111111111111111111111111111
10C00E000000P00000000000000000001
10C000000000000000000000000000001
1C0C10000000000000000000000000001
111110000000000000000000000000001
100000000000000000000000000000001
111111111111111111111111111011111
10C000000000000000000000000000001
10C000000000000000000000000000001
100C10000000000000000000000000001
111110000000000000000000000000001
100000000000000000000000000000001
111111111111111111111111111011111
10C000000000000000000000000000001
10C000000000000000000000000000001
100C10000000000000000000000000001
111110000000000000000000000000001
100000000000000000000000000000001
111111111111111111111111111011111
10C000000000000000000000000000001
10C000000000000000000000000000001
100C10000000000000000000000000001
111110000000000000000000000000001
100000000000000000000000000000001
111111111111111111111111111011111
10C000000000000000000000000000001
10C000000000000000000000000000001
100C10000000000000000000000000001
111110000000000000000000000000001
100000000000000000000000000000001
111111111111111111111111111011111
10C000000000000000000000000000001
10C000000000000000000000000000001
100C10000000000000000000000000001
111110000000000000000000000000001
100000000000000000000000000000001
111111111111111111111111111011111
10C000000000000000000000000000001
10C000000000000000000000000000001
100C10000000000000000000000000001
111110000000000000000000000000001
100000000000000000000000000000001
111111111111111111111111111011111
10C000000000000000000000000000001
10C000000000000000000000000000001
100C10000000000000000000000000001
111110000000000000000000000000001
100000000000000000000000000000001
111111111111111111111111111011111
10C000000000000000000000000000001
10C000000000000000000000000000001
100C10000000000000000000000000001
111110000000000000000000000000001
100000000000000000000000000000001
111111111111111111111111111011111
10C000000000000000000000000000001
10C000000000000000000000000000001
100C10000000000000000000000000001
111110000000000000000000000000001
100000000000000000000000000000001
111111111111111111111111111011111
10C000000000000000000000000000001
10C000000000000000000000000000001
100C10000000000000000000000000001
111110000000000000000000000000001
100000000000000000000000000000001
111111111111111111111111111011111
10C000000000000000000000000000001
10C000000000000000000000000000001
100C10000000000000000000000000001
111110000000000000000000000000001
100000000000000000000000000000001
111111111111111111111111111011111
10C000000000000000000000000000001
10C000000000000000000000000000001
100C10000000000000000000000000001
111110000000000000000000000000001
100000000000000000000000000000001
111111111111111111111111111011111
10C000000000000000000000000000001
10C000000000000000000000000000001
100C10000000000000000000000000001
111110000000000000000000000000001
100000000000000000000000000000001
111111111111111111111111111011111
10C000000000000000000000000000001
10C000000000000000000000000000001
100C10000000000000000000000000001
111110000000000000000000000000001
100000000000000000000000000000001
111111111111111111111111111011111
10C000000000000000000000000000001
10C000000000000000000000000000001
100C10000000000000000000000000001
111110000000000000000000000000001
100000000000000000000000000000001
111111111111111111111111111011111
10C000000000000000000000000000001
10C000000000000000000000000000001
100C10000000000000000000000000001
111110000000000000000000000000001
100000000000000000000000000000001
111111111111111111111111111011111
10C000000000000000000000000000001
10C000000000000000000000000000001
100C10000000000000000000000000001
111110000000000000000000000000001
100000000000000000000000000000001
111111111111111111111111111011111
10C000000000000000000000000000001
10C000000000000000000000000000001
100C10000000000000000000000000001
111110000000000000000000000000001
100000000000000000000000000000001
111111111111111111111111111011111
10C000000000000000000000000000001
10C000000000000000000000000000001
100C10000000000000000000000000001
111110000000000000000000000000001
100000000000000000000000000000001
111111111111111111111111111011111
10C000000000000000000000000000001
10C000000000000000000000000000001
100C10000000000000000000000000001
111110000000000000000000000000001
100000000000000000000000000000001
111111111111111111111111111011111
10C000000000000000000000000000001
10C000000000000000000000000000001
100C10000000000000000000000000001
111110000000000000000000000000001
100000000000000000000000000000001
111111111111111111111111111011111
10C000000000000000000000000000001
10C000000000000000000000000000001
100C10000000000000000000000000001
111110000000000000000000000000001
100000000000000000000000000000001
111111111111111111111111111111111